###########
#####@    #
##  ## # ##
##  #     #
## ## # ###
## ##$ $  #
#  *   $$ #
##  #..$ .#
#   ### #.#
# # # .   #
###########
