###########
##@ #     #
###  # # ##
##.  ..   #
## ## #*###
##  #  $  #
##  #  $  #
## ## $#$ #
## ###.$  #
#   #.    #
###########
