###########
########  #
##    #   #
##  #   # #
#####$$## #
#@ $  . # #
# # .. $. #
#   #$ $ .#
#  #  # # #
#  ## .   #
###########
