###########
########  #
#     #   #
#####     #
##### $$###
# #  $.$@ #
#   ## # ##
# #  $ $  #
# ..  . ###
# # .  . ##
###########
