###########
#@ #  ### #
#     #  .#
#  # $###.#
##### # # #
### .  .  #
###  #$ $ #
###     # #
#####$$*  #
#.        #
###########
